╔═══MM══════╗
║           ║
║         SS║
║ T       SS║
╚════--═════╝
