####MM#######
#           #
#         SS#
# T       SS#
#####--######
