╔═══--══════════╗
║           C   ║
║               ║
║  B            ║
║  B            ║
╚════════WW═════╝
