####--###########
#           C   #
#               #
#  B            #
#  B            #
#########WW######
