╔═══════----══════╗
║                 ║
║     such        ║
║       a         ║
║     great       ║
║      map!       ║
╚═════════════════╝
