╔═══════--═══WW═══╗
║                 ║
║F                |
║OO         TV    |
║OO               ║
║OO        CCCC   ║ 
╚═════════════════╝
