####### #     # #     # ####### ### #     # #######  #####
#       #     # ##    #    #     #  ##   ## #       #     #
#       #     # # #   #    #     #  # # # # #       #
#####   #     # #  #  #    #     #  #  #  # #####    #####
#       #     # #   # #    #     #  #     # #             # 
#       #     # #    ##    #     #  #     # #       #     #
#        #####  #     #    #    ### #     # #######  #####
